Reach the finish


#########
#######F#
######..#
#####..##
####..###
###..####
##..#####
#>.######
#########

loop {
    run
    left
    run
    right
}