Reach the finish


##########
#######.F#
######..##
#####..###
####..####
###..#####
##..######
#>.#######
##########

run
loop {
    left
    run
    right
    run
}