Reach the finish


##########
#.......F#
#.########
#.#......#
#.#.####.#
#.#...<#.#
#.######.#
#........#
##########

loop {
    if scanRight {
        right
    }
    run
}