Reach the finish


########
#.....F#
###.####
###.####
###...##
###.#.##
###...##
###.####
#...####
#.#.####
#...####
###.####
###^####
########

loop {
    run
    if scanLeft {
        if scanRight {
            right
        }
    }
}